......###.#...#.#.#.###.#.#...
...#..##.#..#...#..###..#.####
#...#.#.#..#.#....#.##.####.#.
#..##...##.##....###....##..##
..#.##.#.#.#.#.#.##...#.......
.##...#.##..##.#..#..#####....
.##....##.#.#...#...#..#.#.##.
.##..#..#...##.#.##.##.##.#...
.##.##....#####......##.......
.....##.###..#######.###...#..